. . . . .
. B . S .
. . G . .
. . . . .
. . . . .
